################
e.#######...####
#.##############
#.########..####
#....#####.#####
####.####.######
##...####.######
##.######.######
##....#........#
#####...########
###....#########
###.############
###.......######
#########.######
########.......x
################