#############
e..#.#...#..#
####.##.##.##
#....#..#...x
###.##.######
#...........#
#####.###.###
#...........#
#############